# # # # # # # # # # # #
# . . . # . . . . . . #
. . # . # . # # # # . #
# # # . # . . . . # . #
# . T . . # # # . # . .
# # # # . # . # . # . #
# . . # . # . # . # . #
# # . # . # . # . # . #
# . . . . . S . . # . #
# # # # # # . # # # . #
# . . . . . . # . . . #
# # # # # # # # # # # #