# # # # # # # # # # # # # # # # # # # # # # # # # # # # # # # # # # # # # # # # # # # # # # # # # # # # # # # # # # # # # # # # # # # # # # # # # # # # # # # # # # #
# . . . . . # . # . # . . . . . . . # . # . . . . . . . # . # . . . . . . . . . . . . . . . # . . . . . . . . . . . . . # . . . # . . . . . # . . . . . . . . . . . #
. . # # # # # . # . # . # # # # # . # . # . # # # . # # # . # . # # # # # # # # # # # # # # # . # # # . # # # # # # # # # . # # # . # # # # # . # # # # # # # # # # #
# . . . . . . S . . . . . . . . # . . . . . . . # . # . # . . . . . . . . . . . . . . . . . . . . . # . . . # . # . . . . . # . . . . . . . . . . . . . . . . . . . #
# . # . # # # # # . # . # # # # # # # # # # # # # # # . # . # # # . # # # # # . # # # . # . # # # # # # # # # . # . # # # # # . # # # # # # # # # # # # # # # # # # #
# . # . . . . . # . # . . . # . . . . . . . . . . . . . . . . . # . . . . . # . . . # . # . . . . . . . . . . . . . . . . . . . . . . . . . . . . . . . . . . . . . #
# # # . # . # # # . # # # . # . # # # # # . # # # # # # # # # . # # # # # # # # # . # # # # # # # # # # # # # # # . # # # # # # # . # # # # # # # # # # # # # # # # #
# . . . # . # . # . . . # . # . . . . . # . . . . . . . . . # . # . . . . . . . # . . . . . . . . . . . . . . . # . . . . . . . # . . . . . . . # . . . . . . . . . #
# . # . # . # . # # # # # # # . # # # # # # # # # # # # # # # # # . # # # . # # # # # # # # # . # . # . # . # # # # # # # # # . # . # # # # # # # . # # # # # # # # #
# . # . # . . . . . # . . . . . . . . . . . . . . . . . . . . . . . . . # . . . . . . . . . # . # . # . # . . . . . . . . . # . # . . . . . . . . . . . . . . . # . #
# # # . # . # . # . # . # # # # # . # . # . # . # # # # # . # # # # # # # . # . # . # # # # # # # # # # # . # . # . # # # . # . # # # # # # # # # . # # # # # # # . #
# . . . # . # . # . . . . . . . # . # . # . # . . . . . # . . . . . . . # . # . # . . . . . . . # . . . # . # . # . . . # . # . . . # . . . . . # . . . . . . . # . #
# . # . # . # # # . # . # # # . # # # . # . # . # . # . # # # # # # # # # . # # # # # # # # # # # . # # # . # # # . # # # # # # # # # . # # # # # . # . # . # # # . #
# . # . # . . . # . # . . . # . . . # . # . # . # . # . # . . . . . . . # . . . . . . . . . . . . . . . # . . . # . . . . . . . . . . . . . . . # . # . # . # . # . #
# . # . # . # . # # # . # . # # # # # # # # # # # # # # # . # # # # # # # # # # # . # # # # # # # . # . # # # # # . # # # # # # # # # . # # # # # # # # # # # . # . #
# . # . # . # . . . # . # . . . . . . . . . . . # . . . . . . . . . . . . . # . # . . . . . . . # . # . . . . . # . . . # . . . . . # . # . . . # . . . # . . . . . #
# . # # # . # . # . # . # # # # # . # # # # # # # . # # # # # . # # # # # # # . # # # . # # # . # # # # # . # # # # # # # . # # # # # . # . # # # . # # # . # # # # #
# . # . . . # . # . # . . . . . # . . . # . # . . . . . . . # . . . . . . . . . . . # . . . # . . . # . # . # . # . # . . . . . . . # . . . . . # . . . . . # . # . #
# # # # # # # . # . # # # . # . # . # # # . # . # # # . # . # # # . # . # . # # # # # . # . # . # # # . # # # . # . # . # # # # # . # # # # # # # . # # # # # . # . #
# . . . . . . . # . . . # . # . # . . . . . . . . . # . # . . . # . # . # . . . . . # . # . # . . . . . . . . . . . . . . . . . # . . . . . . . . . . . . . . . . . #
# . # . # # # . # . # . # . # # # # # # # . # # # # # # # # # . # . # # # # # . # # # # # # # # # . # # # # # # # . # # # # # # # # # # # . # . # . # # # # # # # . #
# . # . # . . . # . # . # . . . . . . . # . . . . . . . . . # . # . . . . . # . . . . . . . . . # . . . . . . . # . . . . . . . . . . . # . # . # . . . . . . . # . #
# . # . # # # . # . # . # . # . # . # . # . # . # # # # # . # . # . # # # . # . # # # . # # # # # # # # # # # # # # # . # . # # # # # # # . # # # . # . # # # # # # #
# . # . . . # . # . # . # . # . # . # . # . # . . . . . # . # . # . . . # . # . . . # . . . . . . . . . . . # . . . # . # . . . . . . . # . # . # . # . . . . . . . #
# . # . # . # . # # # # # . # . # # # # # . # . # # # . # . # # # # # # # . # . # # # . # # # # # # # # # . # . # # # # # . # # # . # # # # # . # # # # # # # # # # #
# . # . # . # . . . . . # . # . . . # . . . # . . . # . # . . . . . . . # . # . . . # . . . . . . . . . # . . . . . . . # . . . # . # . # . # . . . . . . . . . . . #
# . # # # # # . # # # # # . # . # . # . # . # . # # # # # # # . # . # . # # # . # . # . # . # . # . # # # # # # # # # # # # # # # # # . # . # . # # # # # . # # # . #
# . # . . . . . . . . . # . # . # . # . # . # . . . . . . . # . # . # . # . . . # . # . # . # . # . . . . . . . . . . . . . . . # . # . # . . . . . . . # . . . # . #
# . # . # . # . # . # # # # # . # # # # # . # . # . # . # . # . # # # . # # # . # . # . # # # . # # # # # # # . # . # # # # # # # . # . # . # # # # # # # # # # # # #
# . # . # . # . # . . . # . . . . . . . # . # . # . # . # . # . . . # . . . # . # . # . . . # . . . . . . . # . # . . . . . . . . . . . . . . . . . . . . . . . # . #
# . # # # # # . # . # # # # # . # # # . # # # # # # # # # . # . # # # # # # # # # . # . # # # . # # # # # . # # # . # . # # # # # . # . # . # . # . # # # # # . # . #
# . . . # . . . # . . . # . . . . . # . . . . . . . . . # . # . . . . . . . . . # . # . . . # . . . . . # . . . # . # . . . . . # . # . # . # . # . . . . . # . . . #
# . # . # # # . # . # . # . # . # # # # # # # # # # # # # # # # # # # # # # # . # . # . # # # . # . # # # # # . # # # . # # # # # # # . # . # . # # # # # # # # # # #
# . # . # . . . # . # . # . # . . . . . . . . . . . . . . . . . . . . . . . # . # . # . . . # . # . . . . . # . . . # . . . . . # . . . # . # . . . . . . . . . . . #
# . # . # . # . # . # # # . # . # . # . # # # . # . # # # # # . # . # . # # # . # . # . # . # . # . # . # # # . # . # # # # # . # # # . # . # . # # # . # . # . # # #
# . # . # . # . # . # . # . # . # . # . . . # . # . . . . . # . # . # . . . # . # . # . # . # . # . # . . . # . # . . . . . # . . . # . # . # . . . # . # . # . . . #
# . # . # # # # # . # . # . # . # . # . # . # . # # # . # . # . # . # # # # # . # # # . # . # # # . # # # . # # # . # . # . # . # . # . # # # . # # # . # . # # # . #
# . # . . . # . . . # . . . # . # . # . # . # . . . # . # . # . # . . . . . # . . . # . # . # . . . . . # . . . # . # . # . # . # . # . . . # . . . # . # . . . # . #
# . # . # . # . # . # # # # # . # . # . # . # . # # # # # # # # # # # # # # # . # # # # # # # . # . # . # . # . # . # . # # # # # # # . # . # . # # # . # . # . # # #
# . # . # . # . # . # . . . . . # . # . # . # . . . . . . . . . . . . . . . # . . . . . # . . . # . # . # . # . # . # . . . . . . . # . # . # . . . # . # . # . . . #
# . # . # . # . # # # . # . # . # # # . # # # . # . # # # # # . # . # # # . # # # . # # # # # # # . # . # # # . # . # . # # # # # . # . # . # . # . # . # . # . # . #
# . # . # . # . # . . . # . # . . . # . # . . . # . . . . . # . # . . . # . . . # . # . . . . . # . # . . . # . # . # . . . . . # . # . # . # . # . # . # . # . # . #
# # # . # . # . # . # # # . # . # . # . # . # . # # # # # . # # # # # # # # # # # # # . # # # . # # # . # # # . # # # . # # # . # # # # # . # # # . # . # # # # # . #
# . . . # . # . # . # . . . # . # . # . # . # . . . . . # . . . . . . . . . . . . . . . . . # . . . # . . . # . # . . . . . # . . . . . # . . . # . # . . . . . # . #
# . # . # . # . # # # # # . # . # . # . # . # . # # # # # . # . # # # # # . # # # # # # # . # # # . # . # # # # # # # . # . # # # . # # # . # . # . # . # . # . # . #
# . # . # . # . # . . . . . # . # . # . # . # . . . . . # . # . # . # . # . . . . . . . # . . . # . # . . . . . . . # . # . . . # . . . # . # . # . # . # . # . # . #
# . # . # . # # # . # # # . # . # . # . # # # . # . # . # # # # # . # . # # # # # # # . # # # # # . # . # # # # # # # . # . # . # . # . # # # # # . # . # . # # # . #
# . # . # . # . . . # . . . # . # . # . # . . . # . # . . . . . . . . . . . . . . . # . # . # . # . # . . . . . . . # . # . # . # . # . . . . . # . # . # . . . # . #
# . # . # . # # # . # # # . # # # # # # # # # . # . # # # # # # # # # # # # # . # # # # # . # . # . # . # . # . # . # . # . # . # . # # # # # . # . # # # . # # # . #
# . # . # . # . . . # . . . . . . . . . # . . . # . . . . . . . . . . . . . # . . . # . . . . . # . # . # . # . # . # . # . # . # . . . . . # . # . . . # . . . # . #
# . # # # # # . # # # # # . # # # # # # # # # . # . # # # . # # # . # . # . # # # . # . # # # # # # # # # . # . # . # . # . # # # . # # # . # # # # # # # # # # # # #
# . . . # . . . # . . . . . . . . . . . # . # . # . . . # . . . # . # . # . . . # . . . . . . . . . . . # . # . # . # . # . . . # . . . # . . . . . . . . . . . . . #
# . # . # # # # # . # . # . # . # . # . # . # . # . # . # # # . # . # . # # # . # # # . # # # . # # # . # . # # # . # . # # # . # # # . # # # # # # # # # . # # # # #
# . # . # . . . . . # . # . # . # . # . . . # . # . # . . . # . # . # . . . # . . . # . . . # . . . # . # . . . # . # . . . # . . . # . . . . . . . . . # . . . . . #
# . # . # . # . # # # . # . # . # # # . # . # # # . # . # # # . # . # . # # # # # # # # # . # . # . # # # . # . # # # . # # # # # . # # # # # # # . # . # . # . # # #
# . # . # . # . # . . . # . # . # . . . # . # . . . # . . . # . # . # . . . . . . . . . # . # . # . . . # . # . . . # . . . . . # . . . . . . . # . # . # . # . . . #
# . # . # . # . # # # # # # # . # # # . # . # # # . # # # # # . # # # . # . # # # . # . # # # . # . # . # . # # # # # . # . # . # . # . # . # . # . # # # . # . # . #
# . # . # . # . # . . . . . . . . . # . # . . . # . . . . . # . . . # . # . . . # . # . . . # . # . # . # . . . . . # . # . # . # . # . # . # . # . . . # . # . # . #
# . # . # . # . # # # # # . # . # . # . # . # # # . # # # # # . # . # . # . # . # . # . # . # # # . # . # . # # # . # . # # # . # # # . # . # . # . # # # . # . # # #
# . # . # . # . # . . . . . # . # . # . # . . . # . . . . . # . # . # . # . # . # . # . # . . . # . # . # . . . # . # . . . # . . . # . # . # . # . . . # . # . . . #
# . # . # . # . # # # # # . # . # . # . # . # # # . # # # # # # # . # # # . # . # . # . # # # . # . # # # # # . # . # . # . # # # # # # # # # . # . # . # . # . # # #
# . # . # . # . # . . . . . # . # . # . # . . . # . . . . . # . . . . . # . # . # . # . . . # . # . . . . . # . # . # . # . . . . . . . . . # . # . # . # . # . . . #
# . # . # . # . # . # . # # # . # . # . # . # # # . # # # . # # # # # . # . # . # . # . # # # # # . # # # # # . # . # # # . # # # # # # # # # . # . # . # . # . # # #
# . # . # . # . # . # . # . . . # . # . # . # . . . . . # . . . . . # . # . # . # . # . . . . . # . . . . . # . # . . . # . . . . . . . . . # . # . # . # . # . . . #
# # # # # . # . # . # . # . # . # # # . # . # . # . # # # # # . # . # # # . # # # . # . # . # # # # # # # # # # # . # . # . # # # # # # # # # . # . # # # # # . # . #
# . . . . . # . # . # . # . # . . . # . # . # . # . . . . . # . # . . . # . . . # . # . # . . . . . . . . . . . # . # . # . . . . . . . # . # . # . . . . . # . # . #
# . # . # . # . # . # . # # # . # # # # # . # # # . # # # # # # # # # # # . # . # . # . # . # # # # # . # . # . # . # . # . # . # # # . # . # # # # # # # . # # # . #
# . # . # . # . # . # . # . . . # . . . . . . . # . . . . . . . . . . . # . # . # . # . # . . . . . # . # . # . # . # . # . # . . . # . . . . . . . . . # . # . # . #
# . # # # . # . # # # . # . # . # # # . # . # . # . # . # # # # # # # # # # # # # . # . # . # . # # # # # . # # # # # . # . # . # # # # # # # . # # # # # # # . # # #
# . # . . . # . # . . . # . # . # . . . # . # . # . # . . . . . . . . . . . . . # . # . # . # . . . . . # . # . . . . . # . # . . . . . . . # . . . . . . . . . . . #
# . # # # . # . # # # # # # # . # # # . # . # # # . # # # . # # # # # . # . # . # . # . # . # . # . # # # . # # # # # # # . # # # . # # # # # # # # # # # # # # # . #
# . # . . . # . # . . . . . . . # . . . # . # . . . . . # . . . . . # . # . # . # . # . # . # . # . . . # . # . # . . . # . . . # . . . . . . . . . . . . . # . # . #
# . # # # . # . # . # # # . # # # . # . # . # # # . # . # . # . # # # # # # # # # # # . # # # # # # # # # # # . # . # # # # # # # . # # # # # # # . # # # # # . # # #
# . # . . . # . # . # . . . # . . . # . # . . . # . # . # . # . . . . . # . # . # . # . . . . . . . . . . . . . . . . . . . # . # . . . . . . . # . . . . . . . # . #
# . # . # . # # # # # # # . # # # . # . # # # . # . # . # . # # # # # . # . # . # . # # # # # . # . # # # # # # # # # # # # # . # # # # # # # # # # # # # # # # # . #
# . # . # . . . # . . . . . # . . . # . . . # . # . # . # . . . . . # . . . . . # . . . . . # . # . . . . . . . # . . . # . . . . . . . . . . . . . . . . . . . . . #
# . # . # . # . # # # # # . # . # . # . # # # . # . # . # . # . # . # # # # # # # . # # # # # . # # # . # . # # # . # # # . # # # . # # # # # # # # # # # . # # # # #
# . # . # . # . # . . . . . # . # . # . . . # . # . # . # . # . # . . . . . . . . . . . . . # . # . # . # . . . # . . . . . . . # . . . . . . . # . . . # . . . # . #
# . # . # . # . # # # . # . # # # # # . # . # . # . # . # . # . # # # . # # # # # # # # # # # # # . # # # # # # # . # # # # # . # # # # # # # . # . # # # # # # # . #
# . # . # . # . # . # . # . # . . . # . # . # . # . # . # . # . . . # . . . . . . . . . . . # . . . # . . . . . # . . . . . # . . . . . . . # . . . . . T . . . # . #
# # # # # # # # # . # . # . # # # . # . # # # # # # # . # . # . # # # # # # # # # . # # # # # . # # # . # # # # # . # # # # # # # # # # # # # . # # # # # # # # # . #
# . . . . . . . . . . . # . . . # . . . . . . . . . # . # . # . . . . . . . . . # . . . . . . . . . . . . . . . . . . . . . . . . . . . . . # . . . . . . . . . . . .
# # # # # # # # # # # # # # # # # # # # # # # # # # # # # # # # # # # # # # # # # # # # # # # # # # # # # # # # # # # # # # # # # # # # # # # # # # # # # # # # # # #